R 1000 700
NO ./textures/purplestone.xpm
SO ./textures/purplestone.xpm
WE ./textures/purplestone.xpm
EA ./textures/purplestone.xpm

D ./textures/purplestone.xpm
S ./textures/pillar.xpm 1
M ./textures/alien.xpm ./textures/blood.xpm 15
H./textures/medkit.xpm 30

F 255,0,255
C 238,130,238

1 1 1 1 1 1 1 1 1 1 1 1 1 1 1 1 1 1 1 1 1 1 1 1 1 1 1 1 1
1 0 0 0 0 0 0 0 0 H 1 1 0 0 0 0 0 M 0 0 0 0 0 0 0 0 0 0 1
1 0 1 1 0 0 0 0 0 1 1 1 0 0 0 0 M M M 0 0 0 0 0 1 0 0 0 1
1 0 4 1 0 0 0 0 0 0 0 0 0 0 0 0 0 M 0 0 0 0 0 0 1 0 0 0 1
1 0 1 1 0 0 0 0 0 1 1 1 0 0 0 0 0 0 0 0 0 0 0 H 1 0 0 0 1
1 0 0 0 0 0 0 0 0 0 1 1 0 0 0 0 0 1 1 1 0 1 1 1 1 2 M 2 1
1 1 1 1 0 1 1 1 1 1 1 1 1 1 0 1 1 1 0 0 0 0 0 0 1 0 0 0 1
1 1 1 1 0 1 1 1 1 1 1 1 1 1 0 1 1 1 0 1 0 1 0 0 1 0 0 0 1
1 1 0 0 0 0 0 0 1 1 0 1 0 1 0 1 1 1 0 0 0 0 0 0 1 0 0 0 1
1 0 0 0 M 0 0 0 0 0 0 0 0 0 0 0 1 1 0 0 0 0 0 0 1 0 0 0 1
1 0 0 0 0 0 0 0 0 0 0 0 0 0 0 0 1 1 H 1 0 1 0 0 1 0 0 0 1
1 1 0 0 0 0 0 0 1 1 0 1 3 1 0 1 1 1 1 1 0 1 1 1 1 0 N 0 1
1 1 1 1 0 1 1 1 1 1 1 1 H 1 0 1 1 1 1 1 0 1 1 1 1 0 0 0 1
1 1 1 1 1 1 1 1 1 1 1 1 1 1 1 1 1 1 1 1 1 1 1 1 1 1 1 1 1
